############
#S.........#
##########.#
#..........#
#.##########
#..........#
##########G#
############
