###################
#S....#...........#
#.###.#.#########.#
#...#.#.....#.....#
###.#.#####.#.###.#
#...#.....#.#...#.#
#.#######.#.###.#.#
#.......#.#.....#G#
#.#####.#.#######.#
#.....#...........#
###################
