###############
#S....#.......#
#####.#.#####.#
#.....#.....#.#
#.#########.#.#
#.........#...#
#.#######.###G#
#.............#
###############
