#############
#S..222.....#
###2#####.###
#..2....#...#
#.22222.###.#
#.....2...#G#
#############
