########
#S.....#
#.####.#
#....#G#
########
