############
#S...#.....#
###.#.#.##.#
#...#.#....#
#.###.####.#
#.....#..G.#
############
