##########
#S.......#
#.######.#
#........#
#.######.#
#.......G#
##########
