##########
#S...#...#
###.#.#G.#
#...#.#..#
#.###.##.#
#........#
##########
